11111
1P0E1
100C1
1C001
11111
