11111
1P001
100C1
1C0E1
11111
